111111111111111111
1C000Z0000000000P1
100000000Z00000001
100110110110110001
100010010010010001
1E0010110110010001
100010010010010001
100010110110010Z01
1C00Z00000000000C1
111111111111111111
