1111111111111111111111111
1000000000000Z00000000001
10CC00111000000CCC0011101
100C0000100111000C0000101
100C00111001C10CCC0000101
100C0000100101000C0000101
10CCC0111000000CCC0000101
1000000Z0000P000000000001
1000000000000000000000001
10CCC011100CCC00010000001
1000C01010000C00010000001
10CCC000000CCC00010010001
10C00010100C0000011110001
10CCC011100CCC00000010001
100Z0000000000000000000E1
1111111111111111111111111
