1111111111111111111111111111111111111111
1E0Z000000000000000000000000000Z000000P1
1Z000000000000000000000000000000000000Z1
100Z000000000000000000000000000000000001
100000000000000000000000C000000000000001
100000000000000C000000000000000000000001
1000000000000000000000Z00000000000000001
1000000000000000000000000000000000000001
1000000000000000000000000000000000000001
10000000000000000000000000000000000C0001
100000000000000000Z000000000000000000001
1000000000000000000000000000000000000001
1000000000000000000000000C00000000000001
1000000000000000000000000000000000000001
1000000000000000000000000000000000000001
100CC00000000000000000000000000000000001
1000000000000000000000000000000000000001
100000000000000000000Z00000000C000000001
1000000000000000000000000000000000000001
1C00000000Z000000000000000000000000000C1
1111111111111111111111111111111111111111
