1111111111111111111111
1C0Z1C00000C000000C1C1
1000100000000011111101
111C1000000C0000000001
1110000011111111111101
1C1C10000000Z0001011C1
1C001111111000101011C1
1000000C000P0010100001
1Z000000001110001C0001
1000001111100011111001
100000100E100C00001001
1011001000111111001001
10C10000000000000Z1001
10C110000C111111C01C11
1111111111111111111111
