111111111111111111111111111111
1C00010000000C00000001000001C1
1010010111111111100001010001P1
10100101000000000000Z001111101
101001000111111110000000000001
101001010000000000000101111111
101011011111111000000100000001
101000000000Z00011111101111101
10101111111110111000010000C101
101001000000000000000100Z00101
101101011111101111110100000101
10010101C000111000C10100000101
11010101000000000001011111C101
100101011111101111110000011101
10110000000000000000011Z0000E1
111111111111111111111111111111
