1111111111
1C01C00Z11
1P00000E11
1111111111