111111111111111111111111111111
1C01C00100000000C00000000000C1
1C11100100000ZC1C0001111111111
10000001C010011111000000000011
1Z0000010010000C000000000000Z1
100000010C10000000111110000001
100100011110000000100100000001
100100000000000001100111110001
100100000000Z10011110000000001
100100000000010011111100000001
1001001110000100CC000111111001
1001C00C1011100001100000001001
1001111110001000Z1000000001001
11C100110000CC0001000111111001
111100110000100001000001000001
1C0100000000100P01000001000001
100100001111111111111111100001
100100000100000100000000000001
1Z00001100000Z110000C000C00001
10011111001100CC111111111110C1
1C000C110011000000000C000000E1
111111111111111111111111111111