1111111111111111111111111111111111111
1Z00000000000000000000000000000000001
10000000000000000000000000000000000Z1
1CP00000000000000000000000000000000E1
1111111111111111111111111111111111111